-1  3 11  3 11  3 11  3 11  3 11  3 11 3 11  3  11  3  11  3 11  3 11  3 11  3 11  3 11  3 3 -1 
-1 13 17 17 17 17 17 17 17 17 17 17 17 17 17 17 17  17 17 17 17 17 17 17 17 17 17 17 17 17 23 -1 
-1 14 17 17 17 17 17 17 17 17 17 17 17 17 17 17 17  17 17 17 17 17 17 17 17 17 17 17 17 17 24 -1 
-1 15 17 17 17 17 17 23  2  4  6  8 14 17 17 17 17  17 17 17 17 17 17 17 17 17 17 17 17 17 22 -1 
-1 13 17 17 17 24  4  6 -1 -1 -1 -1 15 17 17 17 17  17 17 17 17 17 17 17 17 17 17 17 17 17 23 -1 
-1 14 17 22  4  6 -1 -1 -1 -1 -1 -1  2  4 13 17 17  17 17 17 17 17 17 17 17 17 17 17 17 17 24 -1 
-1 15 17 23 -1 -1 -1 -1 -1 -1 -1 -1 -1 -1 14 17 17  17 17 17 17 17 17 17 17 17 17 17 17 17 22 -1 
-1 13 17 24 -1 -1 -1 -1 -1 -1 -1 -1 -1 -1 15 17 17  17 17 17 17 17 17 17 17 17 17 17 17 17 23 -1 
-1 14 17 22 -1 -1 -1 -1 -1 -1 -1 -1 -1 -1 13 17 17  17 17 17 17 17 17 17 17 17 17 17 17 17 24 -1 
-1 15 17 23 -1 -1 -1 -1 -1 -1 -1 -1 -1 -1 14 17 17  17 17 17 17 17 17 17 17 17 17 17 17 17 22 -1 
-1 13 17 24 -1 -1 -1 -1 -1 -1 -1 -1 -1 -1 15 17 17  17 17 17 17 17 17 17 17 17 17 17 17 17 23 -1 
-1 14 17 22 -1 -1 -1 -1 -1 -1 -1 -1 -1 -1 13 17 17  17 17 17 17 17 17 17 17 17 17 17 17 17 24 -1 
-1 15 17 23 -1 -1 -1 -1 -1 -1 -1 -1 -1 -1 14 17 17  17 17 17 17 23 2  4  6  17 17 17 17 17 22 -1 
-1 13 17 24 -1 -1 -1 -1 -1 -1 -1 11  3 11 17 17 17  17 17 17 17 22 -1 -1 -1 13 17 17 17 17 23 -1
-1 14 17 22 11 3  11 3  11 3  11 17 17 17 17 17 17  17 17 17 17 24 -1 -1 -1 14 17 17 17 17 24 -1 
-1 15 17 17 17 17 17 17 17 17 17 17 17 17 17 17 17  17 17 17 17 17 11 3  11 17 17 17 17 17 22 -1 
-1 13 17 17 17 17 17 17 17 17 17 17 17 17 17 17 17  17 17 17 17 17 17 17 17 17 17 17 17 17 23 -1 
-1 14 17 17 17 17 17 17 17 17 17 17 17 17 17 17 17  17 17 17 22 2  13 17 17 17 17 17 17 17 24 -1 
-1 15 17 17 17 17 17 17 17 17 17 17 17 17 17 17 17  17 17 17 23 -1 14 17 17 17 17 17 17 17 22 -1 
-1 13 17 17 17 17 17 17 17 17 17 17 17 17 17 17 17  17 17 17 17 11 17 17 17 17 17 17 17 17 23 -1 
-1 14 17 17 17 17 17 17 17 17 17 17 17 17 17 17 17  17 17 17 17 17 17 17 17 17 17 17 17 17 24 -1 
-1 15 17 23  2  4  2  4  2  4  2  4  2  4  2  4 13  17 17 17 17 17 17 17 17 17 17 17 17 17 22 -1 
-1 13 17 24 -1 -1 -1 -1 -1 -1 -1 -1 -1 -1 -1 -1 14  17 17 17 17 17 17 17 17 17 17 17 17 17 23 -1 
-1 14 17 22 -1 -1 -1 11 3  -1 -1 -1 -1 -1 -1 -1 15  17 17 17 17 17 17 17 17 17 17 17 17 17 24 -1 
-1 15 17 17 11 -1 3  17 17 11 -1 -1 -1 -1 -1 -1 13  17 17 17 17 17 17 17 17 17 17 17 17 17 22 -1 
-1 13 17 17 17 11 17 17 17 17 3  -1 -1 -1 -1 -1 14  17 17 17 17 17 17 17 17 17 17 17 17 17 23 -1 
-1 14 17 17 17 17 17 17 17 17 17 11 -1 -1 -1 -1 15  17 17 17 17 17 17 17 17 17 17 17 17 17 24 -1 
-1 15 17 17 17 17 17 17 17 17 17 17 11 3  11 3  17  17 17 17 17 17 17 17 17 17 17 17 17 17 22 -1 
-1 2  13 17 17 17 17 17 17 17 17 17 17 17 17 17 17  17 17 17 17 17 17 17 17 17 17 17 17 17 23 -1 
-1 -1 4  14 17 17 17 17 17 17 17 17 17 17 17 17 17  17 17 17 17 17 17 17 17 17 17 17 17 17 24 -1 
-1 -1 -1 11  3 11 3  11 3  11 3  11 3  11  3 11 3   11  3 11  3 11 3  11 3  11 3  11 3  11  3 -1

